########################################
########################################
##        #####                       ##
##        ####################        ##
##          ###                       ##
##           ##                       ##
##            #                       ##
##                                    ##
##                                    ##
##                                    ##
##                                    ##
##                                    ##
##                                    ##
##                                    ##
##                                    ##
##                                    ##
##                                    ##
##                                    ##
##                                    ##
##                                    ##
##                                    ##
##                                    ##
##                                    ##
##                                    ##
##                                    ##
##                                    ##
##                                    ##
##                                    ##
########################################
########################################