########################################
########################################
##        #####                       ##
##        ####################        ##
##          ###                       ##
##           ##                       ##
##            #                       ##
##                                    ##
##                                    ##
##                                    ##
##                                    ##
##               #                    ##
##              ### ------------------##
##               #                    ##
##                                    ##
##                                    ##
##                                    ##
##                                    ##
######################                ##
######################                ##
##                                    ##
##                                    ##
##                                    ##
##                                    ##
##                                    ##
##                                    ##
##                                    ##
##                                    ##
########################################
########################################