########################################
########################################
##                                    ##
##        ####################        ##
##          ###                       ##
##           ##                       ##
##            #                       ##
##                                    ##
##                                    ##
##                                    ##
##                                    ##
##                                    ##
##                  ------------------##
##                 |@@@@@@@@@@@@@@@@@@##
##                 |@@@@@@@@@@@@@@@@@@##
##                  ------------------##
##                                    ##
##                                    ##
##~~~~~~~~~~~~~~~~~~~~~               ##
##()()()()()()()()()()()              ##
##                                    ##
##                                    ##
##                                    ##
##                                    ##
##                                    ##
##                                    ##
##                                    ##
##                                    ##
########################################
########################################