    ############   
   / +ACCUEIL+ \   
  /   |  ?  |   \  
 /    |-----|    \ 
/       xxx       \
\                 /
 \               / 
  \             /  
   \   S       /   