                            
   +       +                
     +          +    +  +   
     +    @                 
 + +           +            
          +       +         
@         @                 
    +     @     @           
       +          @         
       +     +              
       +   +       @        