########################################
########################################
##                                    ##
##        ####################        ##
##          ###                       ##
##           ##                       ##
##            #                       ##
##                                    ##
##                                    ##
##                  ------------------##
##                 |@@@@@@@@@@@@@@@@@@##
##                 |@@@@@@@@@@@@@@@@@@##
##                  ------------------##
##                                    ##
##                                      
##                                      
##                                      
                                        
                                        
                                        
                                        
                                        
##                                    ##
##                                    ##
##                                    ##
##                                    ##
##                                    ##
##                                    ##
##                                    ##
###                                   ##
######                                ##
############                ############
########################################
