<          ((               
     w     )))  w           
 w       (((        w       
  T   ((( (((        w      
      ))    ))              
    //////  (((       w     
  //////      )) w    w     
  )))    w  /////         T    
((          /////   T       
<       TTT (((    T        
 v   Y   T   )))  Y    Y    