|||||||||||||||||||
|--|   /   \   |--|
||||  |  .  |  ||||
|--| |       | |--|
||||  .  .  .  ||||
|--|  .     .  |--|
||||     .     ||||
|--|  ..   .   |--|
|||| .  .    . ||||
[[[[[[[[ . ]]]]]]]]