...............**           
..............**  *         
............**  ***        <
..........**  ***   *       
......**####**   *         <
....**    **   ***     <    
***    *    **     *       <
    *                  <  < 
                            
                        << <
                            